scaffold_1	forward	CCTAACCCTAACCCTAACCCTAACCCTAACCCTAACCCTAACCCTAACCCTAACCCTAACCCTAACCCTAACCCTAAAACCTCCACGGCCAGTGCAGCCG
scaffold_2	forward	CCCTAACCCTAACCCTAACCCTAACCCTAACCCTAACCCTAACCCTAACCCTAACCCTAACCCTAACCCTAACCCTAACCCTAACCCTAAAACCTCCACG
scaffold_2	reverse	TTTAAAGTAATCAACAGTGTTTAGGGTTAGGGTTAGGGTTAGGGTTAGGGTTAGGGTTAGGGTTAGGGTTAGGGTTAGGGTTAGGGTTAGGGTTAGGGTT
scaffold_3	forward	CCCTAACCCTAACCCTAACCCTAACCCTAACCCTAACCCTAACCCTAACCCTAACCCTAACCCTAACCCTAACCCTAACCCTAAAACCTCCACGGCCAGT
scaffold_4	forward	CCTAACCCTAACCCTAACCCTAACCCTTAGCAGCAATAAAGTATCCGCTCAATAAATAAACTTAGTGCCTGGGAATTTGGCTTATAAAGAATGGCGCAAA
scaffold_6	reverse	GATATTTAGGCATTAGGTTAGGGTTAGGGTTAGGGTTAGGGTTAGGGTTAGGGTTAGGGTTAGGGTTAGGGTTAGGGTTAGGGTTAGGGTTAGGGTTAGG
scaffold_8	forward	CCTACCCTAACCCTAACCCTAACCCTAACCCTAACCCTAACCCTAACCCTAACCCTAAACCCTAACCCTACATCTCCGACACCCGATAGCGGTGGCGCTT
scaffold_8	reverse	TGTCGGGGAGGGAGATAGAGCGCGAAGCGTAACCGCTTTATCGGGTATGTTGTTAGGGTTAGGGTTAGGGTTAGGGTTAGGGTTAGGGTTAGGGTTAGGG
scaffold_10	forward	TAACCCTAACCCTAACCCTAACCCTAACCCTAAAACTATTTAACTAGATAAAAGATGTTATGGTTAAGACTGACTCTTCTAATTACATGTCTGCTAGTAT
scaffold_11	reverse	ATGTCGGGGAGGGAGATAGAGCGCGAAGCGTAGCCGCTATCGGGTATGTTGTTAGGGTTAGGGTTAGGGTTAGGGTTAGGGTTAGGGTTAGGGTTAGGGG
scaffold_12	reverse	CACACGGTGGGTAATAGGGTTAGGGTTAGGGTTAGGGTTAGGGTTAGGGTTAGGGTTAGGGTTAGGGTTAGGGTTAGGGTTAGGGTTAGGGTTAGGGTTA
scaffold_13	reverse	TATGTTGTTAGGGTTAGGGCATAACCGCTAATCGGTATAGGATATGTCGGGGGAGGGAGATAGAGCGCGAAGCGTAACCGCTATCGGGTATGTTGTTAGG
scaffold_14	forward	CCCTAACCCTAACCCTAACCCTAACCCTAACCCTAACCCTAACCCTAACCCTATTTAACCTCCTATTTAACCTCCTATTTAACCTGCTGTGCTGCCTGCT
scaffold_16	reverse	GGCCGTGGAGGTTTTAGGGTTAGGGTTAGGGTTAGGGTTAGGGTTAGGGTTAGGGTTAGGGTTAGGGTTAGGGTTAGGGTTAGGGTTAGGGTTAGGGTTA
scaffold_45	forward	ATATATATATAATAAAATATTATTGTATTTTATTATAGTATCATGTTAATAATAACTAACCTTCCATTTGATCTACTTAATCATAATAAGAAGTCTTTAA
scaffold_46	reverse	AAAGTAATCAACAGTGTTTAGGGTTAGGGTTAGGGTTAGGGTTAGGGTTAGGGTTAGGGTTAGGGTTAGGGTTAGGGTTAGGGTTAGGGTTAGGGTTAGG
scaffold_56	reverse	CTGTGGTAGGCTGTTAGGTTAGTTAGGTCTATGTTATTCTATTGGAACCCGAACGAAAGCGAAGCGGAATCTCTGGGATCACAATATAGAAGAATACGCC
scaffold_61	reverse	GTTAGGGTTAGGGCATAACCGCTAATCGGTATAGGATATGTCGGGGAGGGAGATAGAGCGCGAAGCGTAACCGCTATCGGGTATGTTGTTAGGGTTAGGG
scaffold_70	reverse	TCACTGTCATTTCCTGAAGGGTCAATCAACTGACTTGAGGATTGCATGGTAGAAAGGCAGTTATAATGATGTGGCAATTGTGAAGGGGTTAGGGTTAGGG

Telomeres found: 19 (8 forward, 11 reverse)
