tig00000039_pilon_pilon_pilon_pilon_pilon_pilon_pilon_pilon_pilon_pilon	reverse	CTGTGGTAGGCTGTTAGGTTAGTTAGGTCTATGTTATTCTATTGGAACCCGAACGAAAGCGAAGCGGAATCTCTGGGATCACAATATAGAAGAATACGCC
tig00000078_pilon_pilon_pilon_pilon_pilon_pilon_pilon_pilon_pilon_pilon	reverse	GATATTTAGGCATTAGGTTAGGGTTAGGGTTAGGGTTAGGGTTAGGGTTAGGGTTAGGGTTAGGGTTAGGGTTAGGGTTAGGGTTAGGGTTAGGGTTAGG
tig00000009_pilon_pilon_pilon_pilon_pilon_pilon_pilon_pilon_pilon_pilon	reverse	GTTAGGGTTAGGGCATAACCGCTAATCGGTATAGGATATGTCGGGGAGGGAGATAGAGCGCGAAGCGTAACCGCTATCGGGTATGTTGTTAGGGTTAGGG
tig00000069_pilon_pilon_pilon_pilon_pilon_pilon_pilon_pilon_pilon_pilon	reverse	CACACGGTGGGTAATAGGGTTAGGGTTAGGGTTAGGGTTAGGGTTAGGGTTAGGGTTAGGGTTAGGGTTAGGGTTAGGGTTAGGGTTAGGGTTAGGGTTA
tig00000066_pilon_pilon_pilon_pilon_pilon_pilon_pilon_pilon_pilon_pilon	forward	CCTAACCCTAACCCTAACCCTAACCCTTAGCAGCAATAAAGTATCCGCTCAATAAATAAACTTAGTGCCTGGGAATTTGGCTTATAAAGAATGGCGCAAA
tig00000068_pilon_pilon_pilon_pilon_pilon_pilon_pilon_pilon_pilon_pilon	forward	CCTAACCCTAACCCTAACCCTAACCCTAACCCTAACCCTAACCCTAACCCTAACCCTAACCCTAACCCTAACCCTAAAACCTCCACGGCCAGTGCAGCCG
tig00000015_pilon_pilon_pilon_pilon_pilon_pilon_pilon_pilon_pilon_pilon	forward	CCCTAACCCTAACCCTAACCCTAACCCTAACCCTAACCCTAACCCTAACCCTAACCCTAACCCTAACCCTAACCCTAACCCTAAAACCTCCACGGCCAGT
tig00000037_pilon_pilon_pilon_pilon_pilon_pilon_pilon_pilon_pilon_pilon	forward	CCTACCCTAACCCTAACCCTAACCCTAACCCTAACCCTAACCCTAACCCTAACCCTAAACCCTAACCCTACATCTCCGACACCCGATAGCGGTGGCGCTT
tig00000037_pilon_pilon_pilon_pilon_pilon_pilon_pilon_pilon_pilon_pilon	reverse	TGTCGGGGAGGGAGATAGAGCGCGAAGCGTAACCGCTTTATCGGGTATGTTGTTAGGGTTAGGGTTAGGGTTAGGGTTAGGGTTAGGGTTAGGGTTAGGG
tig00000060_pilon_pilon_pilon_pilon_pilon_pilon_pilon_pilon_pilon_pilon	reverse	TCACTGTCATTTCCTGAAGGGTCAATCAACTGACTTGAGGATTGCATGGTAGAAAGGCAGTTATAATGATGTGGCAATTGTGAAGGGGTTAGGGTTAGGG
tig00000014_pilon_pilon_pilon_pilon_pilon_pilon_pilon_pilon_pilon_pilon	reverse	GGCCGTGGAGGTTTTAGGGTTAGGGTTAGGGTTAGGGTTAGGGTTAGGGTTAGGGTTAGGGTTAGGGTTAGGGTTAGGGTTAGGGTTAGGGTTAGGGTTA
tig00000084_pilon_pilon_pilon_pilon_pilon_pilon_pilon_pilon_pilon_pilon	forward	ATATATATATAATAAAATATTATTGTATTTTATTATAGTATCATGTTAATAATAACTAACCTTCCATTTGATCTACTTAATCATAATAAGAAGTCTTTAA
tig00000021_pilon_pilon_pilon_pilon_pilon_pilon_pilon_pilon_pilon_pilon	forward	TAACCCTAACCCTAACCCTAACCCTAACCCTAAAACTATTTAACTAGATAAAAGATGTTATGGTTAAGACTGACTCTTCTAATTACATGTCTGCTAGTAT
tig00000042_pilon_pilon_pilon_pilon_pilon_pilon_pilon_pilon_pilon_pilon	reverse	AAAGTAATCAACAGTGTTTAGGGTTAGGGTTAGGGTTAGGGTTAGGGTTAGGGTTAGGGTTAGGGTTAGGGTTAGGGTTAGGGTTAGGGTTAGGGTTAGG
tig00000022_pilon_pilon_pilon_pilon_pilon_pilon_pilon_pilon_pilon_pilon	forward	CCCTAACCCTAACCCTAACCCTAACCCTAACCCTAACCCTAACCCTAACCCTAACCCTAACCCTAACCCTAACCCTAACCCTAACCCTAAAACCTCCACG
tig00000022_pilon_pilon_pilon_pilon_pilon_pilon_pilon_pilon_pilon_pilon	reverse	TTTAAAGTAATCAACAGTGTTTAGGGTTAGGGTTAGGGTTAGGGTTAGGGTTAGGGTTAGGGTTAGGGTTAGGGTTAGGGTTAGGGTTAGGGTTAGGGTT
tig00000007_pilon_pilon_pilon_pilon_pilon_pilon_pilon_pilon_pilon_pilon	reverse	TATGTTGTTAGGGTTAGGGCATAACCGCTAATCGGTATAGGATATGTCGGGGGAGGGAGATAGAGCGCGAAGCGTAACCGCTATCGGGTATGTTGTTAGG
tig00000035_pilon_pilon_pilon_pilon_pilon_pilon_pilon_pilon_pilon_pilon	reverse	ATGTCGGGGAGGGAGATAGAGCGCGAAGCGTAGCCGCTATCGGGTATGTTGTTAGGGTTAGGGTTAGGGTTAGGGTTAGGGTTAGGGTTAGGGTTAGGGG
tig00000074_pilon_pilon_pilon_pilon_pilon_pilon_pilon_pilon_pilon_pilon	forward	CCCTAACCCTAACCCTAACCCTAACCCTAACCCTAACCCTAACCCTAACCCTATTTAACCTCCTATTTAACCTCCTATTTAACCTGCTGTGCTGCCTGCT

Telomeres found: 19 (8 forward, 11 reverse)
